Death Eaters Attack
An Interactive Fiction by Sara Bayat Hashemi
Release 1 / Serial number 221111 / Inform 7 v10.1.2 / D

   - Welcome to Hogwarts 

  Hey muggle, you better find the Dumbledore's Army or Death Eaters will kill you!

Gryffindor common
  It's a circular room where Gryffindor students could relax after a long day of studying. It's full of squashy armchairs, tables, and a notice board where school notices, ads, lost posters, etc., could be posted. 

You can see a notice board (on which is a poster) here.

>read poster
 Dead Eaters broke out from Azkaban!

There are 15 minutes to Death Eaters attack!

>n
corridor
 On your east is the Divination classroom and on the north is Headmaster's office.

You can see an office door and a classroom door here.

There are 15 minutes to Death Eaters attack!

>open classroom door
You open the classroom door.

There are 15 minutes to Death Eaters attack!

>enter the classroom
Divination classroom
  It teaches methods of divining the future or gathering insights into future events, through various rituals and tools. The magic taught in this class, as well as the ability to say prophetic things was a branch of magic referred to as Divination.

You can see a classroom door, a circular table (on which is a wand) and a wooden chest (closed) here.

There are 15 minutes to Death Eaters attack!

>take the wand
 You have taken a dead wizard's wand who was murdered by a death eater. The murderer death eater is the owner of this wand now, and he is on his way with his army to attack Hogwarts.

There are 14 minutes to Death Eaters attack!

>unlock chest
(with the wand)
Alohomora! the chest unlocked..

There are 13 minutes to Death Eaters attack!

>open chest
You open the wooden chest, revealing a crystal ball.

There are 12 minutes to Death Eaters attack!

>take crystal ball
You see a vision of Dumbledore saying, you need to find the Gryffindor sword, and then you will find your path! 

There are 11 minutes to Death Eaters attack!

>w
corridor
 On your east is the Divination classroom and on the north is Headmaster's office.

You can see a classroom door and an office door here.

There are 10 minutes to Death Eaters attack!

>open office door
It seems to be locked.

There are 9 minutes to Death Eaters attack!

>unlock office door with the wand
Alohomora! the door unlocked..

There are 8 minutes to Death Eaters attack!

>enter the office
(first opening the office door)

Headmaster's office
It is a large circular room with many windows and many portraits of old Headmasters and Headmistresses.

You can see an office door and a shelf (on which is a sorting hat (in which is a Gryffindor sword)) here.

There are 7 minutes to Death Eaters attack!

>take the hat
Taken.

There are 6 minutes to Death Eaters attack!

>examine the hat
In the sorting hat is a Gryffindor sword.

There are 5 minutes to Death Eaters attack!

>take the sword
Taken.

There are 4 minutes to Death Eaters attack!

>s
corridor
 On your east is the Divination classroom and on the north is Headmaster's office.

You can see an office door and a classroom door here.

 A secret door appears... as Dumbledore said, the room of requirements appears when you're in very great need of it and contains what you need at that time. So congratulation, make it here. here is the Dumbledore's Army practicing spells. 

    *** Congratulations! you found Dumbledore's Army and you will defeat the death eaters ***

Would you like to RESTART, RESTORE a saved game, QUIT or UNDO the last command?

* * *

Death Eaters Attack
An Interactive Fiction by Sara Bayat Hashemi
Release 1 / Serial number 221111 / Inform 7 v10.1.2 / D

   - Welcome to Hogwarts 

  Hey muggle, you better find the Dumbledore's Army or Death Eaters will kill you!

Gryffindor common
  It's a circular room where Gryffindor students could relax after a long day of studying. It's full of squashy armchairs, tables, and a notice board where school notices, ads, lost posters, etc., could be posted. 

You can see a notice board (on which is a poster) here.

>read
(the notice board)
On the notice board is a poster.

There are 25 minutes to Death Eaters attack!

>north
corridor
 On your east is the Divination classroom and on the north is Headmaster's office.

You can see an office door and a classroom door here.

There are 25 minutes to Death Eaters attack!

>office
That's not a verb I recognise.

>go office
(first opening the office door)
It seems to be locked.

There are 25 minutes to Death Eaters attack!

>go class
You can't see any such thing.

>go classromm
You can't see any such thing.

>go classroom
(first opening the classroom door)

Divination classroom
  It teaches methods of divining the future or gathering insights into future events, through various rituals and tools. The magic taught in this class, as well as the ability to say prophetic things was a branch of magic referred to as Divination.

You can see a classroom door, a circular table (on which is a wand) and a wooden chest (closed) here.

There are 25 minutes to Death Eaters attack!

>pick wand
I didn't understand that sentence.

>take wand
 You have taken a dead wizard's wand who was murdered by a death eater. The murderer death eater is the owner of this wand now, and he is on his way with his army to attack Hogwarts.

There are 24 minutes to Death Eaters attack!

>open chest
It seems to be locked.

There are 23 minutes to Death Eaters attack!

>take wand
You already have that.

There are 22 minutes to Death Eaters attack!

>open chest
It seems to be locked.

There are 21 minutes to Death Eaters attack!

>unlock chest
(with the wand)
Alohomora! the chest unlocked..

There are 20 minutes to Death Eaters attack!

>open chest
You open the wooden chest, revealing a crystal ball.

There are 19 minutes to Death Eaters attack!

>take ball
You see a vision of Dumbledore saying, you need to find the Gryffindor sword, and then you will find your path! 

There are 18 minutes to Death Eaters attack!

>go out
You can't go that way.

There are 17 minutes to Death Eaters attack!

>go door
corridor
 On your east is the Divination classroom and on the north is Headmaster's office.

You can see a classroom door and an office door here.

There are 16 minutes to Death Eaters attack!

>go office
(first opening the office door)
It seems to be locked.

There are 15 minutes to Death Eaters attack!

>unlock office
What do you want to unlock the office door with?

>wand
Alohomora! the door unlocked..

There are 14 minutes to Death Eaters attack!

>go office
(first opening the office door)

Headmaster's office
It is a large circular room with many windows and many portraits of old Headmasters and Headmistresses.

You can see an office door and a shelf (on which is a sorting hat (in which is a Gryffindor sword)) here.

There are 13 minutes to Death Eaters attack!

>open shelf
It isn't something you can open.

There are 12 minutes to Death Eaters attack!

>take sword
Taken.

There are 11 minutes to Death Eaters attack!

>fight
What do you want to fight?

>death eatters
You can't see any such thing.

>go out
You can't go that way.

There are 10 minutes to Death Eaters attack!

>go door
corridor
 On your east is the Divination classroom and on the north is Headmaster's office.

You can see an office door and a classroom door here.

 A secret door appears... as Dumbledore said, the room of requirements appears when you're in very great need of it and contains what you need at that time. So congratulation, make it here. here is the Dumbledore's Army practicing spells. 

    *** Congratulations! you found Dumbledore's Army and you will defeat the death eaters ***

Would you like to RESTART, RESTORE a saved game, QUIT or UNDO the last command?

>hora
Please give one of the answers above.

Would you like to RESTART, RESTORE a saved game, QUIT or UNDO the last command?

>resotre
Please give one of the answers above.

Would you like to RESTART, RESTORE a saved game, QUIT or UNDO the last command?

>RESTART
Death Eaters Attack
An Interactive Fiction by Sara Bayat Hashemi
Release 1 / Serial number 221111 / Inform 7 v10.1.2 / D

   - Welcome to Hogwarts 

  Hey muggle, you better find the Dumbledore's Army or Death Eaters will kill you!

Gryffindor common
  It's a circular room where Gryffindor students could relax after a long day of studying. It's full of squashy armchairs, tables, and a notice board where school notices, ads, lost posters, etc., could be posted. 

You can see a notice board (on which is a poster) here.

>clear
(the notice board)
It is fixed in place.

There are 25 minutes to Death Eaters attack!

>shout up
(to yourself)
There is no reply.

There are 25 minutes to Death Eaters attack!

* * *

Death Eaters Attack
An Interactive Fiction by Sara Bayat Hashemi
Release 1 / Serial number 221111 / Inform 7 v10.1.2 / D

   - Welcome to Hogwarts 

  Hey muggle, you better find the Dumbledore's Army or Death Eaters will kill you!

Gryffindor common
  It's a circular room where Gryffindor students could relax after a long day of studying. It's full of squashy armchairs, tables, and a notice board where school notices, ads, lost posters, etc., could be posted. 

You can see a notice board (on which is a poster) here.

>read it
On the notice board is a poster.

There are 25 minutes to Death Eaters attack!

>kill
(the notice board)
Violence isn't the answer to this one.

There are 25 minutes to Death Eaters attack!

>what should I do?
That's not a verb I recognise.

>fuck you
That's not a verb I recognise.

>suck me
That's not a verb I recognise.

>kiirii
That's not a verb I recognise.

>read
(the notice board)
On the notice board is a poster.

There are 25 minutes to Death Eaters attack!

>read
(the notice board)
On the notice board is a poster.

There are 25 minutes to Death Eaters attack!

>panic
That's not a verb I recognise.

>help
That's not a verb I recognise.

>move right
You can't see any such thing.

>move left
You can't see any such thing.

>move
(the notice board)
It is fixed in place.

There are 25 minutes to Death Eaters attack!

>armchair
That's not a verb I recognise.

>posters
That's not a verb I recognise.

>read poster
 Dead Eaters broke out from Azkaban!

There are 25 minutes to Death Eaters attack!

>defend
That's not a verb I recognise.

>move
(the notice board)
It is fixed in place.

There are 25 minutes to Death Eaters attack!

>north
corridor
 On your east is the Divination classroom and on the north is Headmaster's office.

You can see an office door and a classroom door here.

There are 25 minutes to Death Eaters attack!

>move nroth
You can't see any such thing.

>go north
(first opening the office door)
It seems to be locked.

There are 25 minutes to Death Eaters attack!

>go sought
You can't see any such thing.

>go sout
You can't see any such thing.

>south
Gryffindor common
  It's a circular room where Gryffindor students could relax after a long day of studying. It's full of squashy armchairs, tables, and a notice board where school notices, ads, lost posters, etc., could be posted. 

You can see a notice board (on which is a poster) here.

There are 25 minutes to Death Eaters attack!

>go east
You can't go that way.

There are 25 minutes to Death Eaters attack!

>go west
You can't go that way.

There are 25 minutes to Death Eaters attack!

>go north
corridor
 On your east is the Divination classroom and on the north is Headmaster's office.

You can see an office door and a classroom door here.

There are 25 minutes to Death Eaters attack!

>norht
That's not a verb I recognise.

>north
(first opening the office door)
It seems to be locked.

There are 25 minutes to Death Eaters attack!

>rsdy
That's not a verb I recognise.

>east
(first opening the classroom door)

Divination classroom
  It teaches methods of divining the future or gathering insights into future events, through various rituals and tools. The magic taught in this class, as well as the ability to say prophetic things was a branch of magic referred to as Divination.

You can see a classroom door, a circular table (on which is a wand) and a wooden chest (closed) here.

There are 25 minutes to Death Eaters attack!

* * *

Death Eaters Attack
An Interactive Fiction by Sara Bayat Hashemi
Release 1 / Serial number 221111 / Inform 7 v10.1.2 / D

   - Welcome to Hogwarts 

  Hey muggle, you better find the Dumbledore's Army or Death Eaters will kill you!

Gryffindor common
  It's a circular room where Gryffindor students could relax after a long day of studying. It's full of squashy armchairs, tables, and a notice board where school notices, ads, lost posters, etc., could be posted. 

You can see a notice board (on which is a poster) here.

>read the poster
 Dead Eaters broke out from Azkaban!

There are 25 minutes to Death Eaters attack!

>go north
corridor
 On your east is the Divination classroom and on the north is Headmaster's office.

You can see an office door and a classroom door here.

There are 15 minutes to Death Eaters attack!

>open classroom door
You open the classroom door.

There are 15 minutes to Death Eaters attack!

* * *

>take the wand
 You have taken a dead wizard's wand who was murdered by a death eater. The murderer death eater is the owner of this wand now, and he is on his way with his army to attack Hogwarts.

There are 14 minutes to Death Eaters attack!

>open the chest
It seems to be locked.

There are 13 minutes to Death Eaters attack!

>unlock the chest with the wand
Alohomora! the chest unlocked..

There are 12 minutes to Death Eaters attack!

>open the chest
You open the wooden chest, revealing a crystal ball.

There are 11 minutes to Death Eaters attack!

>take the crystal ball
You see a vision of Dumbledore saying, you need to find the Gryffindor sword, and then you will find your path! 

There are 10 minutes to Death Eaters attack!

>w
corridor
 On your east is the Divination classroom and on the north is Headmaster's office.

You can see a classroom door and an office door here.

There are 9 minutes to Death Eaters attack!

>open office door
It seems to be locked.

There are 8 minutes to Death Eaters attack!

>unlock the office door with the wand
Alohomora! the door unlocked..

There are 7 minutes to Death Eaters attack!

>open the office door
You open the office door.

There are 6 minutes to Death Eaters attack!

>enter the office
Headmaster's office
It is a large circular room with many windows and many portraits of old Headmasters and Headmistresses.

You can see an office door and a shelf (on which is a sorting hat (in which is a Gryffindor sword)) here.

There are 5 minutes to Death Eaters attack!

>take the hat
Taken.

There are 4 minutes to Death Eaters attack!

>examine the hat
In the sorting hat is a Gryffindor sword.

There are 3 minutes to Death Eaters attack!

>take the soword
You can't see any such thing.

>take the sword
Taken.

There are 2 minutes to Death Eaters attack!

>s
corridor
 On your east is the Divination classroom and on the north is Headmaster's office.

You can see an office door and a classroom door here.

 A secret door appears... as Dumbledore said, the room of requirements appears when you're in very great need of it and contains what you need at that time. So congratulation, make it here. here is the Dumbledore's Army practicing spells. 

    *** Congratulations! you found Dumbledore's Army and you will defeat the death eaters ***

Would you like to RESTART, RESTORE a saved game, QUIT or UNDO the last command?

* * *

>read the poster
 Dead Eaters broke out from Azkaban!

There are 25 minutes to Death Eaters attack!

>n
corridor
 On your east is the Divination classroom and on the north is Headmaster's office.

You can see an office door and a classroom door here.

There are 25 minutes to Death Eaters attack!

>open the classroom door
You open the classroom door.

There are 25 minutes to Death Eaters attack!

>enter the classroom
Divination classroom
  It teaches methods of divining the future or gathering insights into future events, through various rituals and tools. The magic taught in this class, as well as the ability to say prophetic things was a branch of magic referred to as Divination.

You can see a classroom door, a circular table (on which is a wand) and a wooden chest (closed) here.

There are 25 minutes to Death Eaters attack!

>take the wand
 You have taken a dead wizard's wand who was murdered by a death eater. The murderer death eater is the owner of this wand now, and he is on his way with his army to attack Hogwarts.

There are 24 minutes to Death Eaters attack!

>open the chest
It seems to be locked.

There are 23 minutes to Death Eaters attack!

>unlock the chest with the wand
Alohomora! the chest unlocked..

There are 22 minutes to Death Eaters attack!

>open the chest
You open the wooden chest, revealing a crystal ball.

There are 21 minutes to Death Eaters attack!

>take the crystal ball
You see a vision of Dumbledore saying, you need to find the Gryffindor sword, and then you will find your path! 

There are 20 minutes to Death Eaters attack!

>w
corridor
 On your east is the Divination classroom and on the north is Headmaster's office.

You can see a classroom door and an office door here.

There are 19 minutes to Death Eaters attack!

>open the office door
It seems to be locked.

There are 18 minutes to Death Eaters attack!

>unlock the office door
What do you want to unlock the office door with?

>wand
Alohomora! the door unlocked..

There are 17 minutes to Death Eaters attack!

>open the office door
You open the office door.

There are 16 minutes to Death Eaters attack!

>enter the office
Headmaster's office
It is a large circular room with many windows and many portraits of old Headmasters and Headmistresses.

You can see an office door and a shelf (on which is a sorting hat (in which is a Gryffindor sword)) here.

There are 15 minutes to Death Eaters attack!

>enter the office
corridor
 On your east is the Divination classroom and on the north is Headmaster's office.

You can see an office door and a classroom door here.

There are 14 minutes to Death Eaters attack!

>open the office door
That's already open.

There are 13 minutes to Death Eaters attack!

>enter the office
Headmaster's office
It is a large circular room with many windows and many portraits of old Headmasters and Headmistresses.

You can see an office door and a shelf (on which is a sorting hat (in which is a Gryffindor sword)) here.

There are 12 minutes to Death Eaters attack!

>drop the crystal ball
Dropped.

There are 11 minutes to Death Eaters attack!

>i
You are carrying:
  a wand

There are 10 minutes to Death Eaters attack!